25:25
#########################
####         @#       ###
#### ################ ###
#### ####          ## ###
#### #### #### ### ## ###
####    # #### #$  ## ###
#### ##=#   ## ###### ###
#    ## ### ## ###    ###
######   ## ##     ##   #
#    # #### ## ######## #
# ####      ## ######## #
#  #### ## ### #     ## #
## #### ## ### # ### ## #
## #### ## ### # ### #  #
#       ## ###=# ### # ##
## ######  ###       # ##
#################### # ##
##       ########### # ##
### #### ##   ###### #  #
###   ## #  # ###### ####
######## # ## ####     ##
#   #### ####      ###$##
# #      ## # #### ### ##
# # ###                 #
#########################
